NO ./Wall1.xpm 
SO ./Wall2.xpm
WE ./Wall3.xpm
EA ./Wall4.xpm  
F 186,164,138    
C 135,206,253

111111111111111111111111111111111111111111111111111111111
110101010101010101011111010101010101010101010101010101011
110111110101010101111111010101010101010101010101110101011
110101110101010101010101010101010101010101010101110101011
110111110101010101111111010101010101010101010101110101011
110101010101010101011111010101010111111101111111110101011
111111110111111111111111111101111111010101010101110101011
111111110111111111111111111101111111011101110101110101011
111101010101010111110111011101111111010101010101110101011
110101010101010101010101010101011111010101010101110101011
110101010101010101010101010101011111010101110101010101011
111101010101010111110111011101010101010101010101010101011
111111110111111111110111011101010101010101010101010101011
110101010101010101011111010101010111010101010101110101011
110101010101010101010101010101010101010101010101011101011
110101010101010101011101010101110101010101010101011101011
1101010101010101010111110111010101010101N1110101010101011
110101010101010101010111010101010101011101110101010101011
111111111111111111111111111111111111111111111111111111111