NO ./texture/w1.xpm 
SO ./texture/w3.xpm
WE ./texture/w4.xpm
EA ./texture/Laava.xpm  
F 30,30,30    
C 117,0,0 


111111111111111111111111111111
100000000000000000000000000001
100000000000000100000000000001
100000001000000000000000000001
100000010100000000000000000001
100000010100000000000000000001
100000010100000000000000000001
100000010100000000000000000001
100000010100000000000000000001
100000000000000000000000000001
100000000000000100000000000001
100000000000001001000000000001
1000000000000101N0100000000001
100000000000001101000000000001
100000000000000100000000000001
100000000000000000000000000001
111111111111111111111111111111