NO ./Wall1.xpm 
SO ./Wall2.xpm
WE ./Wall3.xpm
EA ./Wall4.xpm  
F 186,164,138    
C 135,206,253


111111111111111111111111111111
100000000000000000000000000001
100000000000000100000000000001
100000001000000000000000000001
100000010100000000000000000001
100000010100000000000000000001
10000001N100000000000000000001
100000010100000000000000000001
100000010100000000000000000001
100000000000000000000000000001
100000000000000000000000000001
100000000000000000000000000001
100000000000000000000000000001
100000000000000000000000000001
100000000000000000000000000001
100000000000000000000000000001
111111111111111111111111111111