NO ./Wall1.xpm 
SO ./Wall2.xpm
WE ./Wall3.xpm
EA ./Wall4.xpm  
F 30,30,30    
C 117,0,0 


111111111111111111111111111111
100000000000000000000000000001
100000000000000100000000000001
100000001000000000000000000001
100000010100000000000000000001
100000010100000000000000000001
100000010100000000000000000001
100000010100000000000000000001
100000010100000000000000000001
100000000000000000000000000001
100000000000000100000000000001
100000000000001010000000000001
100000000000010N01000000000001
100000000000001010000000000001
100000000000000100000000000001
100000000000000000000000000001
111111111111111111111111111111