NO ./texture/Wall1.xpm
SO ./texture/Wall2.xpm
WE ./texture/Wall3.xpm
EA ./texture/Wall4.xpm 
F 186,164,138    
C 135,206,253

1111111111111111111111111111111111111
1000000000000000000000000000000000001
1000000000000000000000000000000000001
1000000000000000000000000000000000001
1000000000000N00000000000000000000001
1000000000000000000000000000000000001
1000000000000000000000000000000000001
1000000000000000000000000000000000001
1000000000000000000000000000000000001
1000000000000000000000000000000000001
1000000000000000000000000000000000001
1000000000000000000000000000000000001
1000000000000000000000000000000000001
1111111111111111111111111111111111111
