NO ./texture/Wall1.xpm
SO ./texture/Wall2.xpm
WE ./texture/Wall3.xpm
EA ./texture/Wall4.xpm  
F 186,164,138    
C 135,206,253

1111111111111111111111111111111111111111
1111111111111110000000000000000001111111111111
1111111111111111111111111111111111111111
1111111111111011100010010001111111100001
11111111000001111100E0001000111010101111
10000001000001 1000000011000111111111111
1110000000011110000111101000000000011111
1111111111100000000000111111100111111111
1111111111111111100111000000000000111111
1000000011110001000000000100111101011101
100000001  100110101010000001 1011001111
100000001 111000000111010000111001001011
111111111 111111111111111111101010101011
1111111111111111111111111111111111111111